1111111111111
10E0000000001
10C0000000001
10P0000001001
1111111111111
